




EA ./assets/textures/test2.xpm
NO ./assets/textures/test2.xpm

SO      ./assets/textures/test2.xpm

C 10,22,33

F   26, 17,00

WE ./assets/textures/test2.xpm

11111111111111111111111
10000000000000000000001
10000000000000000000001
10000000000100000000001
10000000001010000000001
10000000000N00000000001
10000000001010000000001
10000000000100000000001
10000000000000000000001
10000000000000000000001
11111111111111111111111