



EA ./assets/textures/text3.xpm
NO ./assets/textures/text1.xpm

SO      ./assets/textures/text2.xpm

C 10,00,054

F   06, 17,00

WE ./assets/textures/text4.xpm
            11111111111111111111111111
             1001000000000000010010001
             1000100000000000100010001
             100000000000N000000010001
             1000000000000000000010001
             1111111111111111111110001
         
                                 10001
                              11110001111
                              10000000001
  1111111111111               10000000001
  1000000000001               10000000001
  1000000000001               10000000001
  1000000000001               10000000001
  1000000000001               10100000101
  1000000000001               10000000001
  10011111111111111111111     11111011111
  1111                             111