NO ./assets/textures/test1.txt
EA ./assets/textures/test1.txt


SO      ./assets/textures/test1.txt

        F      220,100,255
C 225,30,0

WE ./assets/textures/test2.txt


                111111111111111111111111111
               110000000001   10000000000001
        111111101100000111   10000000000001
        111111111111111111111111111111111111
        10010000000000000000000011111111
        111111111011000001110000000000001
        10000000011000001110111111111111
        11110111111111011100000010001
       11110011111111001101010000001
        11000000110101010000000010001
        10000000000000000000000010001
        1000000000000000N001010010001
        110000011101010111101111010111111111111
        11110111 1110101 101111010001
  1   11111111 111111111111111111111
                                                              101
















