




EA ./assets/textures/test1.txt
NO ./assets/textures/test1.txt

SO      ./assets/textures/test1.txt

C 225,30,0

F   1, 0111,000025

WE ./assets/textures/test2.txt

111111111111111111111111111111111
100000000011000000000000111111111
101100000111000000000000111111111
100100000000000000000000111111111
111111111011000001110000000000001
100000000011000001110111111111111
11111111111111011100000010001111111
      111101111111110111010100100011111
1111111111101010111000000100011111
100000000000000011000000100011111
1000000N0000000011010100100011111
110000011101010111110111100011111
11110111 1110101 1011110100011111
11111111 1111111 1111111111111111
