




EA ./assets/textures/test1.xpm
NO ./assets/textures/test1.xpm

SO      ./assets/textures/test1.xpm

C 225,30,0

F   1, 0111,000025

WE ./assets/textures/test1.xpm

111111111111111111111111111111111
100000000011000000000000111111111
101100000111000000000000111111111
100100000000N00000000000111111111
11111111101100011110000000000001
100000000011001    10111111111111
11111111111111011110000010001111111
      111101111111110111010100100011111
1111111111101010111000000100011111
100000000000000011000000100011111
100000000000000011010100100011111
110000011101010111110111100011111
11110111 1110101 1011110100011111
11111111 1111111 1111111111111111
