




EA ./assets/textures/test2.xpm
NO ./assets/textures/test2.xpm

SO      ./assets/textures/test2.xpm

C 10,22,33

F   26, 17,00

WE ./assets/textures/test2.xpm

111111111111111111111111111111111
100000000011000000000000111111111
1011000001110E0000000000111111111
1001000000000000000000000111111111
11111111101100011110000000000001
100000000011001    10111111111111
11111111111111011110000010001111111
      111101111111110111010100100011111
1111111111101010111000000100011111
100000000000000011000000100011111
100000000000000011010100100011111
110000011101010111110111100011111
11110111 1110101 1011110100011111
11111111 1111111 1111111111111111
